50 50
                                                                                  
 ************************************************o********************************
 *       #m$                     #mg *                                           *
 *   b   #m?m                    #$?$*              s                            *
 *       #$m                     #$g *                                           *
 *   #   #######t##f##   ###t#   #   *   *   #   ######t#####f########t######t   *
 *   *                   *       *       *   *   *           *                   *
 *   *                   *       *       *   *   *           *                   *
 *   *                   *       *       *   *m$g*           *                   *
 *   *********************   *************   *m +*   *****   *   *****************
 *       *       *       *   *$m$mm      *   *$rm*       *   *           *   +$mm*
 *       *       *       *   *g?mm$g     *   *m?g*       *   *           *  $g+?m*
 *       *       *    $g *   *+gg$$      *   *mmg*       *   *           *   ++$+*
 *********   *   *   *+$r*   *****   *   *   *********   *   *********   *   *****
 *           *       *$rm*   *       *       *           *       *       *       *
 *           *       *$? *   *       *       *     b     *       *       * b     *
 *           #       #rmr#   t       *       #           #       #       #       *
 *   ##f##   #t###########   #   #**********##   ####tt###f###   #   #t#f#####   *
 *   #mmm#   #               t       *           #       #       #               *
 *   #m? #   #               #       *           #       t       #               *
 *   #$gm#   #               #       *           #       #       #               *
 *   #r$m#   #   ##f#f############   *   ***#f###f   #   #   #################   *
 *   #       f   #               f       *           #       #   $m$ #           *
 *   #       #   #               f       *           #       #   $$?m#           *
 *   #       #   #               t       *           #       #   grrr#           *
 *   f########   #   #########   #********   ####t#######t####   #####   ####t##**
 *               #       #mm+#   #       *   #                           t    gm *
 *               #       #r?m#   #       *   #                           #   m$? *
 *               #       #r+$#   #       *   #                           #    $$ *
 *   #tf###########tf#   #   #   #   *   *   #   ###ff######ftf#f#f####t##   ###**
 *   #       #           t   #       *       #   #$g                g$$g$#       *
 *   #       #           #   #       *       #   #g?m              mgrm?m#       *
 *   f       #           #   #       *       t   #$m                $$$$m#       *
 * k #   f   #   ##f######   ###f#**********##   #####f####f#f$m #   #####   #   *
 *       #   #       #       #       *           f           #$g #           #   *
 *       #   #       #       t       *           #           #g? #           #   *
 *       #   #       #       #       *           #           #$gr#           #   *
 *#t######   ##t##   t $ #   #   #   *   ***######   f####   ##ff##tt##t######   *
 *gmmr               #$mg#       #                   #mg$$$                      *
 *r?$g$              #g?+#       #                   #$?gmrm                     *
 *m$m                *$mg*       *                   *rgrg+                      *
 *********************************************************************************
