30 30
000000000000000000000000000000
011111111111111111111111111110
0100001111111000001bb11111bb10
01111tt1111m1101001bb11111b110
01g1111111111m00011b11+111b110
01111111111$11111bbb111111b110
01111111100001111111111111b110
011111111111011111111111111110
01111111111001g1ww1111111tt110
011111111bb001111111$111111110
01111111bbb1111111mdg111111110
0111111111bb111111111r11111110
011111111111111111111111111110
011111111111111111111111bbb110
01g11111g111111111g1bb11bbb110
01111111111111111111b111bb1110
01111111111111111111b111b01110
011111110111111111111111100110
011111101l1111111k111111100110
01111tt001$1111111111111001110
011111+11111111111111111111110
011111111111111111111111111110
01111111111111111111111$gww110
011111111111111111111111111110
0111111111111b00010001bb111110
011111111111bb110000000b111110
01g111111111b1111100000bb1111o
011111111111b1l111001ttbbb1110
011111111111111111111111111110
000000000000000000000000000000
