30 30
000000000000000000000000000000
011111111111111111111111111110
0111111100000110gm1111$1g11110
011110000100b000b1111111m11010
0111m11111bbb1111111g111111010
0111m11111s1111111111ww1110010
011bg$11111111111111$1gm100110
011bbb111+11111r01111111100010
011bb111111111g001111111111110
o11bb11111111100011111s1111110
011bb1g111111111001111g1111110
0111b1111111111100111111111110
0111b1111111$11111111111111110
011bb111111111ww111111111+1110
011bbb11m1bbg1l1111111111mg110
0111bb11$1bbb11111111111111s10
011bgb1111bbbbb111111+g1111110
01111111111111$111111111m11110
01111111111tt1g11111111s111110
01111111111111+1111b1111ld1110
01g1111111$w1+ww11bb1111111110
0ww1110000000w1111bb1111111110
011110000000011111111111111110
011100111110001kml111111111110
01110111g110101111111111111110
011111111110001111111111111110
011111111110gww111111111111110
01111111111ss111tt111111111110
011111111111111111111111111110
000000000000000000000000000000
