30 30
000000000000000000000000000000
0111111111111111$1111111111110
01111111g111111dgl111111111110
01111111m1111110bbb11bbb111110
01111111ww11d100bbb11w11111110
0111110000001000111$1111111110
01111111111110001111111$111110
011111111111111111111l11111110
01wwg$1111111b1111111111111110
011m111111111b11111111bbb11110
0111111111111b11111111bb111110
01111111$111bb1111111111111110
011b11111111b111$1g11111001110
0111111ww111111111111111010010
0111111111111111111111110rg010
0111111111111l1r11111111000010
011111g1111111gl11k11111111110
01000111111111b111111110000110
01000011111111b11tt11010000110
010011111111tbb111l11000111110
0111g11111bbgb11111111111tt110
0111ww1111bbb11111111111111110
o11111111111111111101111111110
01m111111bbb111111101111111110
0111+11bbbb1111111001110000110
011111111111111111011111110010
01111111111110111l111111111010
011111111111100111111111bbb010
011111111111111111111111111110
000000000000000000000000000000
