30 30
000000000000000000000000000000
011111111111111111111111111110
01111$11bbb11111g1111111tt1110
0111l1111bb1111111111100111110
011111000011111111111100111110
0111110tt111111111111110001110
011111111111111111100100001110
011111111111111111100000011110
0111111111g11110011000g1111110
0111111111l11110011111tbb11110
011111111111110001111ktbb11110
0111111ww11110000111111bbb1110
01111111g1l111gl11111111bb1110
011111111+1111d111111111111110
01111mgww111111111111111111110
01100w$11111111111111111111110
01001ww1111b111111111111111110
01111ww1111tb11111111111111110
0111g111111t111111111111001110
0111111tt11m11111111111101bb10
011100011111111b111+111100bb10
01110001111$111bb1111111000b10
0111011111111bbb11111111000b10
011101111111111111111111111b10
o11100011111111111g11111111110
011100bbb111111110001111111110
0111bbbb1110000110001111111110
0111bbbb1110000111101111111110
011111111111111111111111111110
000000000000000000000000000000
