30 30
000o00000000000000000000000000
0111111111111111111111111ww110
011111g111tt11111111111111g110
011111111bb1100111111111111110
011111111bb0100011111111111110
011111bb1bb0000011111111111110
01111bb1bbbbb11111111111111110
01111bb1111b111111111111111110
0111111111bb111111111111111110
0111111111b11111$111111td11110
0110000111b11111111111$wg11110
0110000$111111$ww111111w111110
01111101111111g111111111111110
01r11111ww11111s11111111111110
011111111111111111111111111110
011111111111111011111111111110
0111ww11b001111011111111111110
01111k1bb001111011111111111110
01111bbbb0001110011111g1111110
0111bbbb1110111b00ww1111111110
011111b11111111b00g11+11100010
011111111b11111100111111100010
011l111bbb11111111l11111100010
01m11bb11111111111111111001010
0111bb111111111111111111111010
011111111111111111111111110010
011011111000111111111$10000010
01100000001001111111r110111110
011111111111111111111111111110
000000000000000000000000000000
