30 30
000000000000000000000000000000
011111$11111111111111111111110
011111g111111111110011111$g110
011111111111111111100111111110
011111111111111110000111111110
011111111111110000000111111110
011111111111110111100111111110
0111111tt111100111111111111110
0111111111111001bb1111g$111110
011111100111100bb11b1111111110
01111110g0111011b1bb1111111110
011111k1d11110d1bbbb1111111$10
0111111111111m1$1bb11111111110
01111111111111l111111111111110
011l111111111111111111b+111110
01b111111111111ww11111b1111110
01b11111111111g111111bg1111110
01b111111111111111111bbm111110
01bb1+111111111111bbb1bbbbg110
011111$111111111bbbb1111111110
0111111111111111g1bb1111111110
0111111111111111bbb11111111110
0111111d1111gm1bb11rgm11111110
0l1111m111$1111b111m1111111110
0+g111100m11111111grb111111110
010000100111111111d1bbbbbb$110
010000111111111111bbbb1bbbg110
011111111111111111bb1111111110
011111111111111111111111111110
000000000000000000000000o00000
