30 30
000000000000000000000000000000
0111111l1111111111111111111110
01110111gb1110g01100111111k110
011100111b11100110011111111110
0100g0111b11b00110011111111110
010001111bbbb01110011111111110
011111111011111111111111g11110
011111111011001111111111111110
0111g1tt100000tt111ww111111110
0111mww11001100111111111110010
011111111111101111111111100110
011111111111bbb111111111100010
01g111111111b1b11111111b110010
01111111111bb1111s11111b110010
01111111111bbb11+1g111bbbbb010
011bbbb11111bb11111111bbbbb010
01bb110011011b11111111bb111110
01b1110100011bb111111111110010
01111bbb00111bb11111111111g010
01111b1bb1111b1111111111wbsw10
01g1111bb11111bb1bb111g1wb$110
o111111b1111+1b1bbb11111wb1110
011111111111rm111b111111ww1110
01100011111111b$11111110000110
01100001m1g11bb111111111000110
011111011111111111111111000110
01g1100111111111111111111m1110
011110t00111111111111111111110
011111t11111111111111111111110
000000000000000000000000000000
