30 30
000000000000000000000000000000
011111111111111111111111111110
0111111111111101bb000011111110
0111111111111101bb011011111110
0111111110000001bb1010g1111110
01111111100011111b10010ww11k10
0m11111111001111bb1000011tt110
0111111111111111ww$1$111111110
011111111111111111111111111110
011111111111111111s11111111110
01111111g111111111g11111111110
011111111111ww1111$11111tt1110
0111111111111m0111111111111110
011b11111111110111111111+11110
011b11111111110111111111111110
011b11111b1111011110111b111110
0$111bbbbb1111011100bbbb111110
011111tt1111bb00010011b1111110
0100001111111b1001000100111110
01tt100111111bb011000000111110
01111b1111111bb111101100g11110
01111bb11111bbb111111111b00110
01111b111111111111111111bb0110
01111btt111l111100111111bb0110
011111111111g11100101111b00110
011111111111111100001$bbb00110
0111111111b111111111l11b111110
01111111bbbbb11111111111111110
011111111111111111111111111110
0000000000000000000000000000o0
