30 30
000000000000000000000000000000
o11111111111111111111111111110
011111111111bb11111111g1111110
011111111111bb11tt111111111110
011111111111111111111111111110
011111111111111111111111111110
011011111111111111111111111110
010010011111111111111111101110
011110000001111111111111100110
01111011111111111111111l110010
01bbb0g11111111111111111m10010
01bbb0111bb11111bb111111111110
011bbbb1bbb11111bb1111111tt110
011bbb111bb1111111111111111110
011b11111bbb111111g111w$111$10
0111d1m11bb00011111111w0010010
01110111gbb0d01111111lg1000010
010001$bbb11101111111111111110
01111111b11$101111111111111110
0$11111bb111101111111111111110
0111111111111011111l1111111110
011111tb11111000111s1011111110
011111bbb11111g001100011111110
011111bbbbb1110001100bb1111110
011111rbgb11111100000bb1111110
01111111100bbb1100000b11111110
01g11111100b1b1100000111$m1110
01s11000001bbb1111000111tt1110
01111111111k111111111111111110
000000000000000000000000000000
