30 30
000000000000000000000000000000
011111111111111111111111111110
0111111111000m1111111111111110
0111111111010tt11000tt11111110
011111111101101110000001111110
01111111110000b111100001111110
011111111b00g0bb11111111001110
011111111b01d$b111111110001110
0111111110011$wwlm111110001110
0111111$ms11d11111ww11w0011110
o111g11111m11111111111g0011110
011111111111bb1111111100001110
0111111110001b1111111111101110
0111111110000b1111111111001110
0111111111100b1111000111001110
0111111111101bbb00011111111110
01111111111011bb011111kbbb1110
011111111111111101b111bbww1110
011111111111111101111bbb111110
01111111111bb1r101bbbbb1wwbb10
011m1$0$111bb111011bgbb111bb10
0111d101000bb000011b$111110010
011111000001101111ww1111110110
011111l$111110111111m111110110
01111wg11111bb1111111111111110
01111w00011+bb1111111111111110
01101001111bb1111111111111g110
0110001111bb111111111111111110
011111111111111111111111111110
000000000000000000000000000000
