30 30
00000000000000000000o000000000
011111111111111111111111111110
010111g1111111111b111111111110
0101111111111111bbbbb111111110
0101111111111111b1111111111110
011111111111111111111111111110
0111111111111bb111111111111110
0111111111111bb111111111111110
0111g11111111bbb11111111gb1110
0111l111111111bb111111111bbb10
0111111111111111111111111bbb10
0111111111111111111111111tt110
011111111111111111111111111110
011111111111111111111111110010
01111111ww11111111111100110010
011111111k11111111111100000110
0111rm1111111111g+111100001110
0111b1m1111111111111111111$l10
011bb111gl11111111111111s11m10
0111b111ww111111111111111$1110
0111b1111111gm1111111111111110
011111111111111111111111111110
011b11101111111111111111111110
01bb1110111011rl11111111111110
01b11100111011g1111111gm111110
0100000111101w$11111111111+110
0101100111101ww1111111111$g110
010111111111111111111111111110
011111111111111111111111111110
000000000000000000000000000000
