30 30
000000000000000000000000000000
0111ww111111111111111111111110
01bb1$gs001111111111111111g110
011bbbb0001111111111111111r110
01g100000000g111111111111bbb10
01110011011111111$1111111bbb10
0111111001111111111111111bgb10
0111111111111100011111111bbb10
0111111111111110111111111bb110
0111111111111m0111110001111110
011111111111100111110001111110
011111111111100111100001111110
01bb11111111100111001111111110
01b111001111bbbb10011111m1111o
01b1110000tt1bbb1111111mgww110
01100100001tt11111111111111110
011000010001111111111111111110
011111111111111111111111111110
0l11$11111g1111111111111111k10
0+111111111111$111111111w+1110
01111111111111gr11111111g11110
0111111111111$111b111111111110
01111111g11100011bb1g111111110
0111111111110001bbb11111111110
0111111111110011bbb11110011110
011111111111b00ttb11bb10111110
01g111111111g100111bb110011110
0111111111bbb00111bbbb11111110
011111111111111111111111111110
000000000000000000000000000000
