
                                                                                  
 **************************************************************o******************
 *       $gg$#           #    $g #                   #$+mm               #       *
 *     kgg+?$#           #   r$?m#                   #r?m$m              #       *
 *       ++$$#           #    mr #                   #m+rg               #       *
 *   tt#######   #   #   #   ###ft   *****   #f##f   ####f####   #####   #   #   *
 *   *           *   *       *       *m$$*       *   *       *   * g$*   *rgg*   *
 *   *           *   *       *       *g?r*       *   *   b   *   *g?$*   *$?m*   *
 *   *           *   *       *       * m$*       *   *       *   *gm+*   *$gm*   *
 *   *   *********   *********   *****+  *****   *   *   *   *   *$$m*   *****   *
 *       *       *   *           *       *       *       *       *r+ *       *   *
 *       *       *   *           *       *       *       *       *   *       *   *
 *       *    $  *   *           *       *       *       *       *   *       *   *
 * b *****   *rmg*   *   *********   *   *   *********************   *****   *   *
 *   *       *m$m*                   *+m *           *           *           *   *
 *   *       *r?g*                   *+?g*           *           *           *   *
 *   #       fmgg#                   *r$ *           #           t           #   *
 *   #   #   t########m+ ##f###t##**********######   #   #####   #   #########   *
 *   #   #   #       #mrmf                           t  $m$$g#                   *
 *   #   f   #       #m?m#                           t $m$m?g#                   *
 *   f   #   #       # $r#                           #  $$ g #                   *
 *   #   t   f   #   ##f##   #####********   ###t#####t######f########f#######   *
 *   #   #   #   #           f       $gm$*   #           #               #mgg#   *
 *   #   #   #   t           #      $+$?$*   f           #               # ?+#   *
 *   #   t   #   #           #       $mmg*   #           #               #++g#   *
 *   #   #   #   #############   #********   #   #t###   #   ###t###f#   # $ #   *
 *       #   #   #m$m                        f   f       #       fgr #   #       *
 *       #   #   #r?gr                       #   #       #       #g?m#   #       *
 *       #   #   #$rm                        #   #       #       # r #   #       *
 *#t######   #   t#f##########f#ft   *******##   #   #########   f   #   #   ##f**
 *           #   #       #       fgm *           #   #       f   #   #   #   #rm *
 *           #   #       #     b #r? *           #   #       f   f   #   #   #m?g*
 *           #   #       #       #gg *           #   #       #   #   #   #   #mmm*
 *   #########   t   #   #   #   #****   ***##t###   #   t   #   #   #   #   # $$*
 *       #       #   f   #   #       *   *$$ #       #   #   #   #   #   #   #$$ *
 *       #       #   #   t   #       *   *m?m#       t   #   #   #   # s #   #   *
 *       #       #   f   #   #       *   * m #       t   #   #   #   #   #   #   *
 *####   #   ####t   #   #   ##f##   *   *   t   #####   #   #   #   #####   #   *
 *+mm    #           f       mgm+#           #           #       #               *
 *$?gm   #           #      $$+?$#           #           #       f               *
 *$gm    *           *       mmr$*           *           *       *               *
 *********************************************************************************
