30 30
000000000000000000000000000000
01111111111111111111111k1m1$10
0111111bbb11111111g$111111gm10
0111$1111b1111111m11111111ww10
011b11111111111111111111111110
01bb11111111111111111111111110
01gb111111ww111111111111111110
01111111s111110011111111111110
01$11111ttgwl100bbgm1111111110
o111ww1100001101bb111111111110
011m11111110011001111111111110
0111s1111111010001111111111110
01111111111111001l111111111110
011111111111111111111111111110
011111111101111111111111111110
0d1111111001111r1$111111111110
01g111111011111111tt1111111110
0$1m11100011m11111111111111110
010011100111gm0111111111111110
01011tt11111r10011111111b11110
01011111111111001111b111b11110
0111111111111111111bb11bbbbb10
011111g11bbb11111111111011bb10
011111111bbbb101111110000bbb10
01111111111b100111111111111110
01111111wwbb1001m1111111110010
0111111111bb110111111111110010
011111111111111111111111100110
011111111111111111111111111110
000000000000000000000000000000
