30 30
000000000000000000000000000000
011111111111111111111111111110
0b11111b11111b1bbb111bb1111110
01b111b1b111b111b111b11b111110
011b1b111b1b1111b111b11b111110
0111b11111b1111bbb11b11b111110
011111111111111111111111111110
011111111111111111111111111110
011111111111111111111111111110
011111111111111111111111111110
011111111111111111111111111110
011111111111111111111111111110
011111111111111111111111111110
011111111111111111111111111110
011111111111111111111111111110
011111111111111111111111111110
011111111111111111111111111110
011111111111111111111111111110
011111111111111111111111111110
011111111111111111111111111110
011111111111111111111111111110
011111111111111111111111111110
011111111111111111111111111110
011111111111111111111111111110
011111111111111111111111111110
011111111111111111111111111110
01111111111111111111l111111110
011111111111111111111111111110
0111111111111111111111111111k0
0000000000000000000000000000o0
