
                                                                                  
 ********************************************************************o************
 *gg+#          rgm$m#                           #m$ #           #          $r$ g*
 *r?r#         mgm$?+#                           #m?g#           t     b   $$$$?r*
 * $+#          mmm$r#                           f$m #           #          $ $m$*
 *   t   #   #t#######   ###t#   #**********##   #   #   #   #   #   #   ##f####**
 *       *       *        $g *           *+m$*   *   *   *   *   *   *           *
 *       *       *        m?r*           *m?$*   *   *   *   *   *   *           *
 *       *       *        +g *           *$ $*   *   *   *   *   *   *           *
 *   *********   *   *****************   *   *   *   *   *   *   *   *********   *
 *   *       *   *   *+m+*               *       *       *   *   *        g$ *   *
 *   *       *   *   *$?r*               *       *       *   *   *       gm? *   *
 *   *    $rm*   *   *$m *               *       *       *   *   *        g  *   *
 *   *   *g$r*   *   *   *   *************   *************   *   *************   *
 *       *rm+*   *   *   *           *mgm    *               *   *       *       *
 *       *m?m*   *   *   *           *$?m+   *               *   *       *     k *
 *       #$  #   #   #   t           *$m+    #               #   #       #       *
 *####   ###t#   #   #   #########   *****   t   ####t########   t   #   #   t   *
 *       f       #   #      m+r$g#       *       #        $g #       #       #   *
 *       #       #   #     grg$?m#       *       #       mg?$#       #       #   *
 *       #       f   #      +g$mm#       *       #        $g #       #       #   *
 *   #####   #   f   t####   #####****   ***##f###   #m $#####f###f##########f   *
 *   #       #   #       t           *           #   #mg$t                       *
 *   #       #   #       #           *           #   #$?g#                       *
 *   #       #   #       #           *           #   #rgm#                       *
 *   #   f###f   t####   #ff###f##   *******##   #   ##f#t   #f###f#######   ###**
 *   #       #    $ggt           #   *           #               t       #   #ggg*
 *   #       t   gm?g#   b       #   *           t               t     s #   #$?m*
 *   #       t    +m+#           #   *           #               #       #   #rm$*
 *   #####   #   #ff##f#######   #   *   ***##   #############   #   #t#f#   #$+r*
 *       t   #m$ #               #   *   *r      #       #$+m    #       t     m *
 *       t   #g?r#               #   *   *m?g    #       #+?rr b #       #       *
 *       #   f $ #               #   *   *g$     #       #$mg    #       #       *
 *####   #   f####   ##t#####t####   *   ***##$m #   t   #####f#ft##tf   f###f   *
 *$gr#   #           #r              *       #mmrf   #   #       m$gg#   #$$$#   *
 *r?+#   #           f$?g            *       tm?$#   #   f      m$g?g#   #$?g#   *
 *g$gt   #           #$$             *       #$m+f   #   #       $$rm#   #mm$#   *
 *m$+#   ######f##f###########   #   *****   #####   #   #   #   ##t##   #r$ #   *
 *m$g                            #  rgrgm*           #       #           #$m     *
 *                               #  mmm?m*           t       t           #       *
 *                               *  m $m$*           *       *           *       *
 *********************************************************************************
