30 30
0000000000000000o0000000000000
011r11111111111111111111111110
01001bbb0011001101111111111110
011bbbbb001000000111111$111110
01bbb1110000g001g1111111g11110
01bbb1100b1bb00111111111111110
011bb1100bbbb11110011111b11110
011111110bbb1$1100011bbbb11110
0111g1tt0100101100011bgbb11110
01b1111t0000000000001bbb111110
01bb111t10g01101g1m00011111110
0111111bb000bb01111b1011111110
01b11bbbbbb01001l11b0011111110
01bbbbbb11b0000011bb1111111110
01bb11111111100011111111111110
011111111111111111111111l11110
01111m111111111111111111g$1110
011111111111111111111111111110
011111111111111111111111111110
011111111111111111111111111110
0111111111111111g1111111111110
011111111111111111111111111110
0111l111111rg111111wg111111110
01111000111000001mwr1111111110
0111g000111111001$111111111110
011111001111111111111111111110
01101t00111111111111m11m111110
011000001111111111111111111110
01k111111111111111111111111110
000000000000000000000000000000
