
                                                                                  
 ****o****************************************************************************
 *                       #       # $         #   #                               *
 *                       #       #$?$        # s #                               *
 *                       #       # m         t   #                               *
 *   #   #############   #   t   #****   *   #   f   ####f#######f#########t##   *
 *   *           *++m*       *   *       *   *   *       *           *           *
 *   *           *r?$*       *   *       *   *   *       *       b   *           *
 *   *           *+g *       *   *       * $ *   *       *           *           *
 *   *********   *$gg*********   *   *****  $*   *****   *   *****   *   *********
 *       * g *   *+r$      m *   *       *$$g*       *   *       *   *   *       *
 *       *m?$*   *        $?$*   *       *+?m*       *   *       *   *   *       *
 *       * $ *   *         g *   *       * rm*       *   *       *   *   *       *
 *****   *   *   *   *********   *****   *********   *   *****   *   *   *   *   *
 *$$ *       *   *               *       *           *   *       *   *       *   *
 *m?+*       *   *               *       *           *   *       *   *       *   *
 *$$$#       #   #               #       *           #   #       #   #       #   *
 *m +#####   t   ###t#####   #####   *****   #f#t#####   #   ##f##   ###t#####   *
 *mmmt       #           #       #       *   #g+$m       #   mmm$#   #           *
 * m #       #           #       #       *   #m?mm$      t  g$g?mt   t           *
 *   #       #           #       #       *   #$+$r       t   mg$m#   #           *
 *   #   ####ft##t####   ####t   #****   *   #####+g #   #########   #   #t##ft#**
 *   #       #   rmm$#       #           *       #mg$#   #           #   #       *
 *   f       #  mg ? f       #           *       # ?g#   #           #   #       *
 *   t       #   $$gm#       #           *       #$r+#   #           #   #       *
 *   #####   f   ####t####   ##f##****   ***##   #t###   f b #   #####   #   #   *
 *       #   #         $ #       #       *mgr#   #       #   #   #       #   #   *
 *       #   #        m? f   k   f b     *m?m#   #       #   #   #       #   #   *
 *       #   #g$       $ #       #       *mm+#   #       #   # g #       #   #   *
 *   #   #   fr$$#   ###t#t###   #   ***** $ t   #   ##t##   #gmg#   #####   #   *
 *   #       # mg#           #   #           t   #   #r$     #$gm#           #   *
 *   #       #m?+#           #   #           #   #   #g?+    #g?m#           #   *
 *   #       #+$$#           #   t           #   #   #$m     #+$g#           t   *
 *   #####f###tf###f#ftf##   #   f********   #   #   tf###   ###############f#   *
 *       #$g$+               #   #rmmr$      t   #   #       #            g$g#   *
 *       #+?mgg              #   # ?g$       #   #   #       #           g+?+#   *
 *       #$$m$               t   #gm$g$      f   #   #       #            rgm#   *
 *####   ####t   ######f##   #   #**********##   #   #   #####   ff#t#   #f###   *
 *g              #$mmr$      #                       #           $mmm#           *
 *g?r            #r?r$+m     #                       #          mgg?g#           *
 *mg             *$$ggm      *                       *           $mmr*           *
 *********************************************************************************
