30 30
000000000000000000000000000000
011111111111111111111111111110
011111111111gr1111111111111110
011+1111111111111111111b111110
01g1$11111111111111111bb111110
011l111111r111111111+111111110
011111111l1111111bg11111111110
01111111111100011bb11111111110
01111k111111000000b1111111g110
011+111111tt11100000bbww111$10
01111111g11111b01000bbgl111110
011d1$11111111b010000000111110
011111111111111010000010111110
011011111111111111111111111110
0110bb110011111111111111001110
0110b1111001111111111110001110
o100bb111101111111111110011110
0d01111110011tt111111111111110
01g11111100111111111111bbb1110
0111111111001111111111111bb110
011111111111111111g1m11111bb10
01111r111111111111111111111b10
01111111111111111100111111gb10
01111111111111111110b111111110
01111111111111110000bb11111110
01111111111111110001b111111110
0111111111111b1b00011111111110
01111111111111bb00011111111110
011111111111111111111111111110
000000000000000000000000000000
