
                                                                                  
 ****************o****************************************************************
 *mm m   #                   #                                               #r$m*
 *m?$r+m t                   f                                               fg?g*
 *gmmmm  #                   #                                               #mmm*
 *####   #   f   ##f######   #   #**********ff###t###t   #ff######f###t###   #gmm*
 *       *   *       *+$$$   *   *       *           *   *            g$ *   *grg*
 *       *   *       *m?$mg  *   *       *           *   *           rm?$*   * $ *
 *       *   *       *mr$r   *   *       *           *   *            $r *   *   *
 *   *****   *****   *********   *   *   *   *****   *   * b *****   *****   *   *
 *   *       *$+$*                   * m *   *gg *   *   *    $$$*       *   *   *
 *   *       *m?g*                   *m?g*   *g?$*   *   *   +$?m*       *   *   *
 *   *       *$m$*                   * g *   *$$ *   *   *    mm$*       *   *   *
 *   *   *****g$g*************************   *   *   *   *************   *   *   *
 *   *   * g     *       *       *           *       *   *           *       *   *
 *   *   * ?$    * s     *       *           *       *   *           *       *   *
 *   #   # g     f       f       #           #       f   #           t       #   *
 *   #   ##f##   #####   #   #   #   *******t#   ###f#   #   ####f   ####t   #   *
 *   #       #       #       #       *   g +$#       #   #       #       t   f   *
 *   #       #       #       #       *   g$?mt       #   t       #       #   #   *
 *   #       #       #       #       *   gmmgt       #   #       #       #   #   *
 *   ##f##   f##t#   #####f#######****   ***###f#f   #   #####   #####   #   #   *
 *       #           #rmr#               *           #       #   #+ +#   t   #   *
 *       t       b   # ?m#               *           f       #   #+?g#   #   #   *
 *       t           #rm$#               *           #       #   #g+m#   #   #   *
 *   #   #####f### b # r #   #####****   *   #######f#####   f   f   #   #   #   *
 *   #         m #       #           *       #$gmmr          t       #   #       *
 *   #         ?g#       #           *       #g?g$rr         #       #   t       *
 *   #    r $  $ #       #           *       #$gmg$          #       #   #       *
 *   f   #+mmf####ft##   #t##f####   *******t####t####   f##ft#ft#   t   #####   *
 *$m #   f$gg#       #   f     $ #           #       #               #   # gmrr  *
 *m?$#   #$?m#       #   #    g?rf           #       #               #   f+?$ $+ *
 *m$ #   #g $#       #   #     g #           #       f               #   #g$$mr  *
 *#f##   #####   #   #   f   ###f#********   #   #   #   #############   ##t##   *
 *       #       t       #               *   #   #   t$$ #           #       #   *
 *     k #       #       f               *   #   f   #+? #           #       #   *
 *       #       #       f            mmr*   #   t   t + #           #       #   *
 *   ##t##   ###t#tff######t###t##   *m+$*   #   #   #####   t#ft#   ###t#   # m *
 *                                   *$gm*       #           #g  m           #$m *
 *                                   *m?$*       #           #m?m$m          #g?$*
 *                                   *mgg*       *           *r  g           *g+m*
 *********************************************************************************
