30 30
000000000000000000000000000000
01111111111111111m111111111110
0111gl1111111111g1bbb111g11110
011111111111111111bbb111111110
011111111111111111bb1111111110
0111ww111111111111bbb10l111110
011111111mg1111111gww1g1111110
011111001rsm11111111m101111110
01b100000111111111111111111110
01bbb1110111111111111111111110
011bb110tt11111111111111111110
0111111111111111d1001111111110
011111111100111110001111111110
011111111000111100001111111110
01111lg110bb1$g0000000tt111110
0111111100bb11100tt00111111110
011111110111111111bb111mgm1110
0111111101111111111b1b11111110
010111110111111111gbbbb11b1110
01001l11011111111111bbbbbb1110
01001111001111111111b1bb111110
0100011111111111111111bb111110
01000111g11111111111111111g110
010011111111111111111111111110
0110111111111111k1111111111110
0111ww11111m1111111$1b11111110
01111111111mg11111111bbb1tt110
011111111111111111111bbb111110
011111111111111111111111111110
000000000000000000000000o00000
