30 30
00000000000000o000000000000000
0111111111111111111111111$1110
011111111l$11111g1111111111110
0111111111111111111111111+l110
0111111111111111100000b1111110
0111111111111111100000b1111110
011111111111111111bb00b1111110
01101m11111111111bbb0111111110
01101111111111111bb10111111110
011100000100011111b11111111110
011110000100011111l10010000110
0111110011000$1tt1110010110010
0111111100011mg110100010111010
011111111111111100bbb011111110
0111111111bbb11110bbb001111110
01111l111bbbb111100bb111111110
0111111111bbg1000001g111g11110
0111bb111111b1010011111$+11110
0111bb111111111100111111111110
01111bbbb1+1k11100011111111110
01111bbbb1g1111111111111111110
01111b1bb+11111111bbb111$11110
011111g11111111111bbb111g11110
0111111111111111111bb111111110
0111111111111111111bb111111110
01111111111111111111bb11111110
01bbg1111111tt111111bb00111110
01bb+1111111111111111100111110
011111111111111111111111111110
000000000000000000000000000000
