30 30
000000000000000000o00000000000
011111111m11111111111111111110
01111111g100111111g111tt110110
01$111111110011111111111110110
011011111110g1111111111$110110
010000011110011111111111110110
011111b11111111111111111111110
011111bm1111111111111111111110
011111bbg1111111d1100111111110
011111bbb11111t$11101111100010
0111b111111111t111001111100010
0111b1111111111111000011100110
011bb1111$g111g11bbbg011111110
011b11111m1$11m11bb1000b111110
0111111bb11111111111000bb11110
0111111bbbb111111111101bb11110
0111g1111b1b11111111101bb11110
0111l111111111111111101bb11110
0111111111111111g111111b111110
011111111111111111111111111110
01111k111111111111111111111110
01111111111111111111111m111110
0111111111111111111111g1111110
011111111111s11111111111111110
01bb1111111s11111lg1w001100110
01bb1bbb111111111111ww00000110
01g1111tt111111111b11111g11110
01111111111111111bb11011$tt110
011111111111111111111111111110
000000000000000000000000000000
