30 30
000000000000000000000000000000
011111111111111tt1111111111110
01111111bbb1111w11111111111110
01111$r111b1111ww1001111111110
011111g$11b1111111000111111110
011111111db1111111t00110111110
011111111wg11111110011b0011110
011111111ww11111b11111bb011110
011111111111k1bbb11111b0011110
0111111111111bbbb1110000111110
01111111111111111bb101g0$11110
o10111b11111111111bbb0011$1110
01011bb1111111111tt1001bg11110
01011bb111111b111111011bb11110
01011bb11111bbbb11b1111bb11110
0111bbb111111b1111b1111b111110
01111bb11111111111111111111110
01s11b111111111111111111111110
0111111111111111111111111ww110
0$1111l111tt11l111111111111110
011110gr1111d11111111110111110
011110$ww1111m1r1111100tt00110
011110100111111111111000100110
011110100011111111111110001110
011110001111111111111110011110
011111111111111111111100001110
01111111111111111m111110001110
011111111111111111111000001110
011111111111111111111111111110
000000000000000000000000000000
