30 30
000000000000000000000000000000
011111111111111111111111111110
011111111111111000011111111tt0
0111tt111111011111111111111110
011111111110g1111111r11bbb1110
0111tt111111m111b1111111b11110
01l001111111111bbbb00111b11110
0w00011bb111111b1bb000000bb110
0wg0111bb1111111100010000b1b10
0d1s111bb1111111101111100bb110
01w0011b111111100011111111bb10
01000011111111101111$111111110
01001111111111101111gl11111110
01100b1d1111000111111111111110
01111111111100011111bb111bbb10
01111111b11101111111bbbbbb1b10
0111b111bbg111111111111m1b1110
0111bb111111111111111111111110
0111bbgm1111111111111111111110
0111b1111111111111111111111110
0111b111g1s111111111111t111110
011bb111d11111111111bb1t111110
010b0111111110011111bb11111110
010b01tt11111101111bbb11110110
0100011111111100111b1111110010
01111111m11111111w011111111010
o1111111g11111111w011111110010
01111111111111111w011d1k110110
01111111111111111ww11111111110
000000000000000000000000000000
